R 700 700
NO ./textures/brick1.xpm
SO ./textures/brick2.xpm
WE ./textures/brick3.xpm
EA ./textures/brick4.xpm
S ./textures/8bit.xpm
F 169,169,169
C 135,206,235

1111111111111111111111111111
1000000100000000000000000001
100000000000000000000000W001
1000000100000000000000000001
1000000100000000000000000001
1000000100000000000000000001
1000000100000000000000000001
1000000100000000000000000001
1002000100000000000000000001
1000000100000000000000000001
1000000100000000000000000001
1111111111111111111111111111