R 900 900
NO ./textures/brick1.xpm
SO ./textures/brick2.xpm
WE ./textures/brick3.xpm
EA ./textures/brick4.xpm
S ./textures/8bit.xpm
F 169,169,169
C 135,206,235

1111111111111111111111111
1000000000110000000000001
1011000001110000002000001
1001000000000000000000011
1111111110110000011100001
1000000000110111111111111111111
10000000000001
1000000000000011111111111111111
11000000110101011100000000001
100000000000000011000000020001
10000000000000001101010000001
1100000111010101111100000N0111
11110111 1110101 101111010001
11111111 1111111 111111111111
