R 1000 1000

NO ./textures/brick1.xpm
SO ./textures/brick2.xpm
WE ./textures/brick3.xpm
EA ./textures/brick4.xpm
S ./textures/8bit.xpm
F 169,169,169
C 135,206,100

1111111111111111111111111
1000000E00000000000000001
1000000000000000000200001
1000000000000000000000001
1000000000000000000000001
1000000000000000000000001
1000000000000000000000001
1000000000000000011111111
10000010000000001
1000001000000000111111111
1000001000000000000000001
100000100000000000000001
1000001000000000000000001
1111111111111111111111111