R 640 480
NO ./textures/brick1.xpm
SO ./textures/brick2.xpm
WE ./textures/brick3.xpm
EA ./textures/brick4.xpm
S ./textures/8bit.xpm
F 220,100,0
C 225,30,0
11111111
10002001
10000001
100N0001
10000001
11111111