R 1000 1000

NO ./textures/brick1.xpm
SO ./textures/brick2.xpm
WE ./textures/brick3.xpm
EA ./textures/brick4.xpm
S ./textures/8bit.xpm
F 169,169,169
C 135,206,100

 111111               1 11
10000001             101001   111
 1110001    1111     1010001110001
10200001   100201    1000000000201
10001111   100001    1000011100001
100000201110001001111 12010001001
 11100000000001000000100001110001
100020010S00201000100002000010001
 110000100001110010100111100010001
   1001 1001   1001001    10011011111
   1001 1201    10001     100000000001
   100010001     111       1111111111
   100000001
    1111111
