R 1080 1080
NO ./textures/brick1.xpm
SO ./textures/brick2.xpm
WE ./textures/brick3.xpm
EA ./textures/brick4.xpm
S ./textures/8bit.xpm
F 192,192,192
C 135,206,235

1111111111111111
1000000000000001
1000200000000001
1000000000000001
1000000000000001
1000000000000001
10000N0000000001
1000000000000001
1000000000000001
1111111111111111

