R 1080 1080

NO ./textures/brick1.xpm
SO ./textures/brick2.xpm
WE ./textures/brick3.xpm
EA ./textures/brick4.xpm
S ./textures/8bit.xpm
F 169,169,169
C 135,206,235

1111111111111111111111111
1000000000110000000100001
101100S001110000000100201
1001000000000000000100001
1100100000000001000100101
1001000200000000000100101
1100100000000000000100101
1001000000010000000100101
1001000000000000000100101
1001000000000000000100101
1000000000000001000000101
1100000000000000000000101
1001000001000000000000001
1111111111111111111111111

