R 1080 1080

NO ./textures/brick1.xpm
SO ./textures/brick2.xpm
WE ./textures/brick3.xpm
EA ./textures/brick4.xpm
S ./textures/8bit.xpm
F 192,192,192
C 135,206,235

1111111111111111111111111
1000000000110000000000001
1011000001110000000000001
1001000000000000000000001
1100100000000000000000001
1001000000200000000000001
1100100000000000000000001
1001000000000000000000001
1001000000000N00000000001
1001000000000000000000001
1000000000000000110101001
1100000111010101111101111
1001000000000000000000001
1111111111111111111111111

